PON PON PON
Choo Choo Train
VICTORY
ヘビーローテーション	헤비 로테이션
Everyday、カチューシャ	에브리데이 카츄샤
Chu Chu
New World
CAN'T GET BACK
愛を止めないで
LOVE ＆ JOY
じょいふる	죠이풀
アイデンティティ	아이덴티티
Garden
つけまつける	츠케마츠케루
CANDY CANDY
SPELL MAGIC
ニブンノイチ	이분의일
サラバ、愛しき悲しみたちよ	안녕, 사랑스러운 슬픔들이여
女々しくて	메메시쿠테	소심하니까
LOVEドッきゅん♥	러브도큥
GO!!!
カルマ	카르마
リライト	리라이트
READY STEADY GO
Butter-Fly	버터플라이
創聖のアクエリオン	창성의 아쿠에리온
残酷な天使のテーゼ	잔혹한 천사의 테제	에반게리온
galaxias!
Tachyon	타키온
リクライム	리클라임
恋のヒメヒメぺったんこ
サブリナ	사브리나
RPG
GO MY WAY!!
THE IDOLM@STER 2nd-mix
The world is all one !!
Get Off of My Way
おいでよ！妖精の森
みかんのうた	귤의 노래	미칸의 노래
ファミリーパーティー	패밀리 파티
恋愛サーキュレーション	연애 서큘레이션	세노
Can Do
The Other self
カノン	카논
オルフェ	오르페
ヘタリアン☆ジェット	헤탈리안 제토
ココロオドル	코코로 오도루
naraku within
ほとんど違法行為
シリウス	시리우스
青春はNon-Stop！	청춘은 non-stop
Falling Roses
ようかい体操第一	요괴 체조제일
ゲラゲラポーのうた
Scatman (Ski Ba Bop Ba Dop Bop)	스캇맨	스캣맨
でんでんぱっしょん	덴덴 패션
Dragon Night
Luminize
秘密の扉から会いにきて
Touch Tap Baby
イチズレシピ	이치즈 레시피
ふ・れ・ん・ど・し・た・い	친구하고 싶어	학교생활
未来(ソラ)の歌	미래의 노래
ひみつをちょーだい	비밀을 초대
夏にキスしていいですか？
PERFECT HUMAN
SUSHI食べたい feat.ソイソース
7 Girls War
Jumping!!
ゆりゆららららゆるゆり大事件
いぇす！ゆゆゆ☆ゆるゆり♪♪
ちょちょちょ！ゆるゆり☆かぷりっちょ！！！
H-A-J-I-M-A-R-I-U-T-A-!!	하지마리 우타
Star☆Glitter
紅蓮の弓矢	홍련의 화살	진격의 거인	진격거
SAKURAスキップ	사쿠라 스킵	sakura 스킵
Now Loading!!!!
ホシトハナ	별과 꽃
Stand Up!!!!
ヤバい○○	야바이
Pursuing My True Self
Signs Of Love (“Never More” ver.)
specialist (“Never More” ver.)
Time To Make History (AKIRA YAMAOKA Remix)
CALL HEAVEN!!
Sunshine world tour
POP TEAM EPIC	팝팀에픽
全力☆Summer!	전력summer
Arrival of Tears
にめんせい☆ウラオモテライフ！
うまるん体操
夏祭り	나츠마츠리
SAVIOR OF SONG
かくしん的☆めたまるふぉ～ぜっ！
Deep in Abyss
NOISY LOVE POWER☆
極上スマイル	극상 스마일
甲賀忍法帖	갑하인법첩
Ievan Polkka
LOSER
U.S.A.
新宝島	신보도
未完成人	미완성인
シュガーソングとビターステップ	슈가송	비터스텝	슈가송과 비터스텝	혈계전선
Daydream café
コネクト	커넥트
The Gong of Knockout
Clattanoia
UNION
東奔西走行進曲	동분서주행진곡
Soul-ride ON!
乗ってけ！ジャパリビート
フレ！フレ！ベストフレンズ
POPPY PAPPY DAY
アウトサイダー	아웃사이더
絵の上手かった友達
ワンダーラスト	원더라스트
Mr. Wonderland
ジャガーノート	저거노트	저거너트
アリサのテーマ	아리사의 테마
True Love Song	트루 러브 송
Color My World	컬러 마이 월드
Future	퓨처	퓨쳐
Love You	러브 유
In Chaos	인카오스	원투
Crush On You	크러시온유
Sun Dance	선댄스
Sweets×Sweets	스윗츠스윗츠
Love or Lies
ネコ日和。
虹と太陽
炭★坑★節
NIGHT OF FIRE	나이트오브파이어
come again	컴어게인	컴어겐
jelly	젤리
ハッピーシンセサイザ	해피신디사이저
ルカルカ★ナイトフィーバー	루카루카 나이트 피버	루카루카
源平大戦絵巻テーマソング	검은소	원평대전	원평대전회권	원평대전회권테마송
美しく燃える森
ウッーウッーウマウマ(ﾟ∀ﾟ)	우마우마	카라멜단센
Beat Of Mind	비트오브마인드
檄！帝国華撃団(改)	격! 제국화격단	격! 제국화격단 개	제국화격단
メランコリック	멜랑콜릭
教えて!! 魔法のLyric
ZIGG-ZAGG	지그재그
ワールズエンド・ダンスホール	월드엔드댄스홀	월즈엔드댄스홀
パンダヒーロー	판다히어로
オレンジの夏
BaBan!! －甘い罠－
ジングルベル	징글벨	징
マトリョシカ	마트료시카
メグメグ☆ファイアーエンドレスナイト	메구메구
きみのためなら死ねる
怪盗Rのテーマ
マリアをはげませ
SHOW TIME	쇼타임
JACKY [Remix]	재키	재키 리믹스
天国と地獄	천국과 지옥
City Escape: Act1	시티 이스케이프
Rooftop Run: Act1	루프탑런
Reach For The Stars	리치포더스타스	리치포더스타즈	리치포더스타	소닉컬러즈	소닉컬러
Urban Crusher [Remix]	어반크러셔	어반크러셔 리믹스
Catch The Future	캐치더퓨쳐	캐치더퓨처
おちゃめ機能	장난기 기능
ダンシング☆サムライ	댄싱 사무라이
BAD∞END∞NIGHT	배엔나	배드엔드나이트
ロミオとシンデレラ	로미오와 신데렐라
Sweetiex2
腐れ外道とチョコレゐト	썩은 외도와 초콜렛
スイートマジック	스위트 매직
ゴーゴー幽霊船	고고 유령선
千本桜	천본앵
We Gonna Party	위고너파티
Streak	스트릭
Lionheart	라이온하트
Acceleration	액셀러레이션
Sprintrances	스프린트랜스
air's gravity	공기중력	에어그라비티	중력
Starlight Disco	스타라이트 디스코
犬日和。
デコボコ体操第二
御旗のもとに
DO RORO DERODERO ON DO RORO	도로로
Natural Flow	내츄럴 플로우
maimaiちゃんのテーマ
Quartet Theme [Reborn]
Sky High [Reborn]	스카이하이
Like the Wind [Reborn]	라이크더윈드
YA･DA･YO [Reborn]	야다요
Space Harrier Main Theme [Reborn]	스페이스해리어
Tell Your World	텔유어월드
FEEL ALIVE	필얼라이브
Link (maimai)	링크 (마이마이)
Night Fly	나이트플라이
Feel My Fire	필마이파이어
Spin me harder	스핀미하더
Fragrance	프랙	프래그런스
39
炎歌 -ほむらうた-	호무라우타	염가
ソーラン☆節	소란부시
地上の戦士	지상의 전사
超絶！Superlative
采配の刻 Power of order
Endless World	엔들리스 월드
ぴぴぱぷぅ！
Turn around	턴어라운드
Nerverakes	널버	널브레이크
Black Out	블랙아웃
泣き虫O'clock
君の知らない物語	너가 모르는 이야기	네가 모르는 이야기
脳漿炸裂ガール	뇌장	뇌장작렬걸
カゲロウデイズ	카게로우	카게로우 데이즈
チルノのパーフェクトさんすう教室	치르노	치르노의 퍼펙트 산수교실
Bad Apple!! feat.nomico	배드애플
Grip & Break down !!	그립 앤 브레이크 다운
ナイト・オブ・ナイツ	나오나	나이트오브나이츠
時空を超えて久しぶり！	뿌요뿌요
Her Dream Is To Be A Fantastic Sorceress
神室雪月花	카무로 설월화
KONNANじゃないっ！
awake
Terminal Storm	터미널스톰
記憶、記録	기억기록
Blew Moon	블루문
Pixel Voyage
Get Happy	겟해피
Beat of getting entangled	인탱글
Cosmic Train	코스믹트레인
maiム・maiム feat.週刊少年マガジン
Backyun! －悪い女－
みんなのマイマイマー
円舞曲、君に
Burning Hearts ～炎のANGEL～	버닝하트	버닝하츠	버닝엔젤
いーあるふぁんくらぶ	12 팬클럽	하나둘 팬클럽
Ignite Infinity
トルコ行進曲 - オワタ＼(^o^)／	오와타	터키행진곡
ココロスキャンのうた	코코로 스캔
Mysterious Destiny
Riders Of The Light
Save This World νMIX	세이브 디스 월드
Living Universe
イアイア★ナイトオブデザイア
魔理沙は大変なものを盗んでいきました	마리사
Help me, ERINNNNNN!!（Band ver.）	에린	헬프 미 에린
夜咄ディセイブ	야화 디세이브	요바나시 디세이브
ウサテイ	우사테이
LUCIA	루시아
Death Scythe	데스사이드	데스사이스
BREAK YOU!!	브레이크유
JUMPIN' JUMPIN'	점핑점핑	점핀점핀
L'épilogue	에필로그	레필로그
ローリンガール	롤링걸
放課後ストライド	방과후 스트라이드
全人類ノ非想天則
しゅわスパ大作戦☆
Garakuta Doll Play	가라쿠타	가라쿠타 돌 플레이
System “Z”	시스템 지	시스템 제트
＊ハロー、プラネット。	헬로 플래닛
セガサターン起動音[H.][Remix]	세가 새턴
ぽっぴっぽー	포피포
裏表ラバーズ	겉과 속의 러버즈	겉과 속의 러버스	우라오모테 러버스	겉속 러버즈
DADDY MULK -Groove remix-	대디멀크
弱虫モンブラン	겁쟁이 몽블랑
セツナトリップ	세츠나 트립
Nyan Cat EX	냥캣
I ♥
天ノ弱	아마노자쿠	천성의 약함
モザイクロール	모자이크 롤
sweet little sister
ぐるぐるWASH！コインランドリー・ディスコ
Monochrome Rainbow	모노크롬 레인보우
お嫁にしなさいっ！
最速最高シャッターガール
林檎華憐歌
YATTA!	얏타
Windy Hill -Zone 1	윈디힐
コトバ・カラフル	코토바 컬러풀
アゲアゲアゲイン
鼓動	고동
DRAGONLADY	드래곤레이디
SPiCa	스피카
magician's operation
M.S.S.Planet
二息歩行	이식보행
かせげ！ジャリンコヒーロー
キズナの物語
CYCLES	사이클
Heartbeats
Life Feels Good	라이프 필즈 굿
MYTHOS	미소스
End of Twilight
ファンタジーゾーン OPA-OPA! -GMT remix-
電車で電車でGO!GO!GO!GC! -GMT remix-
RIDGE RACER STEPS -GMT remix-
リッジでリッジでGO!GO!GO! -GMT mashup-
オパ! オパ! RACER -GMT mashup-
電車で電車でOPA!OPA!OPA! -GMT mashup-
火炎地獄	화염지옥
患部で止まってすぐ溶ける～狂気の優曇華院	환부
神々の祈り
エピクロスの虹はもう見えない	에피크로스	에피쿠로스
言ノ葉カルマ	코토노하 카르마
タカハせ！名人マン	명인맨	타카하세	타카하세 명인맨
Outlaw's Lullaby	아웃로	아웃로우	럴러바이
Brand-new Japanesque
レッツゴー!陰陽師	렛츠고 음양사	음양사
からくりピエロ	카라쿠리 피에로	꼭두각시 피에로
リリリリ★バーニングナイト	릴리릴리 버닝나이트	릴리릴리
POP STAR	팝스타
待チ人ハ来ズ。
幻想のサテライト	새틀라이트	환상의 새틀라이트
バラライカ	바라라이카
Jack-the-Ripper◆	잭더리퍼
Danza zandA	단자잔다
Live & Learn	리브앤런
Endless, Sleepless Night
Back 2 Back	백투백
シアワセうさぎ	시아와세 우사기
むかしむかしのきょうのぼく
ハロ／ハワユ	헬로 하와유
深海少女	심해소녀
ダブルラリアット	더블 래리엇	더블 래리어트
緋色のDance	비색의 댄스	비색의 Dance
明星ロケット	명성 로켓	샛별 로켓
MIRROR of MAGIC	미러 오브 매직
One Step Ahead	원 스텝 어헤드
B.B.K.K.B.K.K.	베이스킥	베킥
おこちゃま戦争	어린이 전쟁
Link	링크
Dreampainter	드림페인터
The Great Journey
きたさいたま2000	키타	키타사이타마	키타사이타마2000	사이타마
FLOWER	플라워
Got more raves？	갓모레
shake it!
毒占欲	독점욕
BETTER CHOICE	베터 초이스
VERTeX	버텍스	베르텍스
Ignis Danse	이그니스	이그니스 댄스	이그니스 단스
Scars of FAUNA	스카	스카스 오브 파우나	파우나
FUJIN Rumble	후진	후진럼블	푸진럼블	푸진
アンハッピーリフレイン	언해피 리프레인
planet dancer	플래닛 댄서
Cosmic Magic Shooter	코스믹 매직 슈터	코매슈
ピーマンたべたら	피망 타베타라	피망
究極焼肉レストラン！お燐の地獄亭！	야키니쿠
Heart Beats
oboro	오보로
Dragoon	드라군	드래군
不毛！	후모	부모
おても☆Yan	오테모 얀
Caliburne ～Story of the Legendary sword～	칼리번	털리번
ナミダと流星
みくみくにしてあげる♪【してやんよ】	미쿠미쿠하게 해줄게
ロストワンの号哭	호곡	묵뿣	로원호	로스트원의호곡
ケロ⑨destiny
ってゐ！ ～えいえんてゐVer～
L9
赤心性：カマトト荒療治	적심성	카마토토
響縁	향연
悪戯	악희
welcome to maimai!! with マイマイマー
クローバー♣クラブ	클로버 클럽
妄想税	망상세
ウミユリ海底譚	우미유리	해저담	우미유리 해저담	갯나리 해저담	갯나리
Our Fighting
若い力 -SEGA HARD GIRLS MIX-
Oshama Scramble!	오샤마	오샤마 스크램블
D✪N’T  ST✪P  R✪CKIN’	돈스탑락킹	돈스락
ガラテアの螺旋	가라테아	나선	가라테아의 나선
東方スイーツ！～鬼畜姉妹と受難メイド～	동방 스위츠
1/3の純情な感情
キャプテン・ムラサのケツアンカー	캡틴 무라사
はじめまして地球人さん	처음 뵙겠습니다 지구인씨
どうしてこうなった	어째서 이렇게 된 거야
どういうことなの！？	어떻게 된 거야!?
Change Our MIRAI！
六兆年と一夜物語	육조년	육조년과 하룻밤 이야기
Sweet Devil
デッドレッドガールズ	레데걸	레드 데드 걸스	레드 데드 걸즈
ストリーミングハート	스트리밍 하트
おじゃま虫
LANCE	랜스
Aiolos	아이올로스
Yet Another ”drizzly rain”
四次元跳躍機関	사차원도약기관
最終鬼畜妹・一部声	최종귀축 여동생 일부성	일부성
Axeria	악세리아	악세
初音ミクの消失	소실	하츠네 미쿠의 소실
+♂	플러스 남	플러스 남자	플러스 단시	플단
Counselor	카운셀러
言ノ葉遊戯	코토노하 유희
りばーぶ	리버브
幾四音-Ixion-	익시온
HIMITSUスパーク	히미츠 스파크	비밀 스파크
Party 4U ”holy nite mix”	파티포유	파티4유
物凄い勢いでけーねが物凄いうた	굉장한 기세로 케이네가 굉장한 노래
すろぉもぉしょん	슬로모션
閃鋼のブリューナク	섬강	브류나크	섬강의 브류나크
アージェントシンメトリー	아젠트 시메트리
LOL -lots of laugh-
イノコリ先生	이노코리 선생	이노코리 센세
厨病激発ボーイ	중병격발 보이
Revive The Rave
YU-MU
フラグメンツ -T.V. maimai edit-	프래그먼츠	프래그먼트
願いを呼ぶ季節
囲い無き世は一期の月影
After Burner	애프터버너
7thSense	칠감	세븐센스
ラブリー☆えんじぇる!!	러블리 엔젤
オモイヨシノ	오모이요시노
GEMINI -M-	제미니
ありふれたせかいせいふく	흔해빠진 세계정복
頓珍漢の宴	톤친칸	톤친칸의 연	얼뜨기의 연회
Garden Of The Dragon
FEEL the BEATS	필더비츠
スリップフリップ	슬립플립
橙の幻想郷音頭
東方妖々夢 ～the maximum moving about～
蒼空に舞え、墨染の桜
少女幻葬戦慄曲 ～ Necro Fantasia	네크로판타지아
Jimang Shot	지망샷
Glorious Crown	글크
無敵We are one!!	무적
儚きもの人間	덧없는 인간	덧없는것 인간
キミノヨゾラ哨戒班	너의 밤하늘 초계반
恋愛裁判	연애재판
METATRON	메타트론
fake!fake!	페이크 페이크
Invitation	인비테이션
月に叢雲華に風
connecting with you
高気圧ねこロック	고기압 고양이 록	고기압 네코록
パーフェクト生命	퍼펙트생명
Infantoon Fantasy
洗脳	세뇌
Contrapasso -paradiso-	콘트라파소	콘파
東京リアルワールド	동경 리얼월드	도쿄 리얼월드
しんでしまうとはなさけない！	죽어버리다니 한심하구나!
Jumble Rumble	점블럼블
Hand in Hand	핸드 인 핸드
クノイチでも恋がしたい	쿠노이치라도 사랑이 하고 싶어
Barbed Eye
セハガガガンバッちゃう！！
brilliant better
Hyper Active	하이퍼액티브
No Routine	노루틴
ひれ伏せ愚民どもっ！
エテルニタス・ルドロジー	에테르니타스 루돌로지
Nitrous Fury	니트러스	나이트로스	니트로스
CITRUS MONSTER	시트러스	시트러스 몬스터
ハート・ビート	하트비트
終わりなき物語	끝나지 않는 이야기
やめろ！聴くな！
木彫り鯰と右肩ゾンビ	목각 메기와 오른쪽 어깨 좀비	좀비
ECHO	에코
AMAZING MIGHTYYYY!!!!	어메이징	마이티	어메이징 마이티	어메마
Prophesy One	프로페시	프로페시원
ゴーストルール	고스트룰
Last Brave ～ Go to zero
STAIRWAY TO GENERATION
空威張りビヘイビア	허세 비헤이비어
回レ！雪月花	돌아라 설월화	마와레
taboo tears you up	타부
夜明けまであと３秒	새벽까지 앞으로 3초	3초
色は匂へど散りぬるを	향기로운 꽃도 언젠간 지는 법
ファッとして桃源郷
すーぱーぬこになりたい	슈퍼 누코가 되고 싶어
いっしそう電☆舞舞神拳！	마이마이신권
ゆっくりしていってね！！！	느긋하게 있어!!!
チュルリラ・チュルリラ・ダッダッダ！	츄루리라·츄루리라·땃땃따!	츄루리라
生きてるおばけは生きている
踊れオーケストラ	춤춰라 오케스트라
Our Wrenally	레널리	아와레날리	레날리
フォルテシモBELL	포르티시모 벨
conflict	컨플	컨플릭트
DETARAME ROCK&ROLL THEORY	데타라메
Sakura Fubuki	사쿠라 후부키
私の中の幻想的世界観及びその顕現を想起させたある現実での出来事に関する一考察
GOODMEN	굿맨	굿멘
ドキドキDREAM!!!	도키도키 드림
Selector	셀렉터
HERA	헤라
分からない	와카라나이
ポップミュージックは僕のもの
きらっせ☆ウッド村ファーム
その群青が愛しかったようだった
Imitation:Loud Lounge	이미테이션
Lividi	리비디
だんだん早くなる	단단 하야쿠 나루	점점 빨라져
ココロ	코코로
吉原ラメント	요시와라 라멘트
ねぇ、壊れタ人形ハ何処へ棄テらレるノ？	망가진 인형	저기, 망가진 인형은 어디에 버려지는거야?
The wheel to the right	휠투라
四月の雨	사월의비
Scream out! -maimai SONIC WASHER Edit-	스크림 아웃
幽闇に目醒めしは
Starlight Vision	스타라이트 비전
Club Ibuki in Break All	브레이크 올	클럽 이부키
Phantasm Brigade
天火明命	천화명명
Panopticon	파놉	파놉티콘
炉心融解	노심융해
ネトゲ廃人シュプレヒコール	온라인 게임 폐인 슈프레히코어	네토게
Just Be Friends
StargazeR
華鳥風月	화조풍월
リンカーネイション	리인카네이션	리인카
宿題が終わらないっ！
GO BACK 2 YOUR RAVE
天国と地獄 -言ノ葉リンネ-
夢花火	유메하나비	몽화화
Paradisus-Paradoxum
前前前世	전전전세	젠젠젠
オトヒメモリー☆ウタゲーション	오토히메모리	우타게이션	오토히메모리 우타게이션
ラブチーノ	러브치노
ヘルシーエンド	헬시 엔드
東京レトロ	동경 레트로	도쿄 레트로
ARROW	애로우
バッド・ダンス・ホール	배드 댄스 홀
ちがう!!!	치가우	지가우	아니야
KISS CANDY FLAVOR	키스 캔디	키스캔디 플레이버
Maxi	맥시
人里に下ったアタイがいつの間にか社畜になっていた件	노노워킹
相思創愛	상사창애
心象蜃気楼	심상신기루
光線チューニング	광선 튜닝
Limit Break
曖昧mind	아이마이 마인드	애매 마인드
KING is BACK!!	킹이즈백
Ultranova	울트라노바
GET!! 夢&DREAM
真・ハンサム体操でズンドコホイ
Moon of Noon	문눈	문오브눈
デスパレイト	데스퍼레이트
Starlight Dance Floor	스타라이트 댄스플로어
妖精村の月誕祭 ～Lunate Elf	요정촌의 월탄제
オーディエンスを沸かす程度の能力 feat.タイツォン	오디엔스	오디언스
チルノのパーフェクトさんすう教室　⑨周年バージョン	치르노의 퍼펙트 산수교실 9주년 버전	치르노 9주년
My Dearest Song
猛進ソリストライフ！	솔리스트	맹진	맹진 솔리스트 라이프
幸せになれる隠しコマンドがあるらしい	행커	행복 커맨드
白ゆき	시라유키	백설
名探偵連続殺人事件	명탐정연속살인사건
エイリアンエイリアン	에일리언 에일리언
フラジール	프라질	프래질
日本の米は世界一	일본쌀	쌀	일본의 쌀	일본의 쌀은 세계제일
ないせんのうた	나이센노 우타
Calamity Fortune	칼포	칼라미티	캘러미티	칼라미티 포츈
ユビキリ	유비키리
泡沫、哀のまほろば
ようこそジャパリパークへ	자파리 파크	어서 오세요 자파리 파크에
あ・え・い・う・え・お・あお!!	학교생활
MilK	밀크
咲キ誇レ常世ノ華
Magical Flavor	매지컬 플레이버
REVIVER オルタンシア・サーガ -蒼の騎士団- オリジナルVer.	리바이버	오르탄시아 사가	오르텐시아 사가
拝啓ドッペルゲンガー	도플갱어	친애하는 도플갱어	친애하는 도플갱어에게
砂の惑星 feat. HATSUNE MIKU	모래의 행성	모래행성
アンノウン・マザーグース	언노운 마더구스
Bang Babang Bang!!!
Tic Tac DREAMIN’	틱택 드리밍
SPICY SWINGY STYLE
白い雪のプリンセスは	하얀 눈의 프린세스는
好き！雪！本気マジック	좋아! 눈! 진심 매직	스키 유키 혼키 매직	스키 유키 본기 매직
スターナイトスノウ	スターナイトスノウ
This game	디스 게임
Los! Los! Los!	혈계전선
Signature	시그니처	시그니쳐
ドーナツホール	도넛홀
人生リセットボタン	인생 리셋 버튼
しねばいいのに	시네바 이이노니	죽으면 좋겠는데	죽었으면 좋겠는데
もうみんなしねばいいのに	모두 죽었으면 좋겠는데
Excalibur ～Revived resolution～	엑스칼리버	엑칼	엑스털리버
ギリギリ最強あいまいみー！
ミラクル・ショッピング	돈키호테	미라클 쇼핑
Kinda Way
共感覚おばけ
麒麟	기린
Credits	크레딧스	크레딧츠	크레딧
ナンセンス文学	넌센스 문학
Candy Tall Woman	캔디 톨 우먼
ダンスロボットダンス	댄스 로봇 댄스
アルカリレットウセイ	알칼리 열등생
ドクハク	독백	도쿠하쿠
キレキャリオン	베어라 캐리온	키레캐리온
猫祭り	네코마츠리	고양이축제
TRUST	트러스트
Still	스틸
ガヴリールドロップキック	가브리엘 드롭킥
fantastic dreamer	판타스틱 드리머
SPILL OVER COLORS	스필오버	스필오버 컬러스
エンドマークに希望と涙を添えて	엔드마크	엔드마크에 희망과 눈물을 더하며
永遠のメロディ	영원의 멜로디
天狗の落とし文 feat. ｙｔｒ
疾走あんさんぶる	질주 앙상블
Doll Judgment	돌 저지먼트
WARNING×WARNING×WARNING	워닝워닝워닝
Justified	저스티파이드
Mare Maris	마레마리스
シャルル	샤를
フリィダム ロリィタ	프리덤 로리타
バレリーコ	발레리코
アウターサイエンス	아우터 사이언스
妄想感傷代償連盟	망상감상대상연맹
LOVE EAST	러브이스트
Fist Bump	피스트 범프	소닉 포시즈
ENERGY SYNERGY MATRIX	이에스엠	에너지 시너지 매트릭스
Session High⤴	세션하이
World Vanquisher	월뱅	월드뱅퀴셔
FestivaLight	페스티벌라이트
アンチクロックワイズ	안티클록와이즈
Seyana. ～何でも言うことを聞いてくれるアカネチャン～	세야나
Brain Power	브레인 파워
進め！イッスン軍団 -Rebellion of the Dwarfs-
Let's Go Away	데이토나
Rodeo Machine	로데오	로데오 머신
Conquista Ciela
keep hopping	킵호핑
larva	라바
ブリキノダンス	브리키의 댄스
インビジブル	인비저블	인비지블
彗星ハネムーン	혜성 허니문
おねがいダーリン	오네가이 달링
ヒビカセ	히비카세
初音ミクの激唱	격창	하츠네 미쿠의 격창
えれくとりっく・えんじぇぅ	일렉트릭 엔젤
ミラクルペイント	미라클 페인트
CYBER Sparks	사이버 스파크
Xevel	제벨
ULTRA B+K	울베킥	울트라 베이스킥
INFINITE WORLD	인피니트 월드
Ragnarok	라그나로크
サドマミホリック	사도마미	사도마미 홀릭
みんなの	민나노
アマノジャクリバース feat. ｙｔｒ	아마노자쿠 리버스	아마노쟈쿠 리버스
進捗どうですか？	진척
Help me, あーりん！	아린
なるとなぎのパーフェクトロックンロール教室	나루와 나기의 퍼펙트 록앤롤 교실	나루나기
あねぺったん	아네페탕	아네페땅
We Gonna Journey	위 고나 져니	위 고나 저니
FREEDOM DiVE (tpz Overcute Remix)	프다	프리덤다이브
ジンギスカン	징기스칸
にじよめちゃん体操第一億	니지요메
花と、雪と、ドラムンベース。	꽃눈드	꽃눈베	꽃눈디	꽃과 눈과 드럼 앤 베이스
このふざけた素晴らしき世界は、僕の為にある	이 실없이 멋진 세계는, 나를 위해 있어
このピアノでお前を8759632145回ぶん殴る	이 피아노로 너를	이 피아노로 너를 8759632145번 후려갈긴다
はやくそれになりたい！	하야쿠 소레니 나리타이	빨리 그것이 되고 싶어!
フィクサー	픽서
SILENT BLUE	사일런트 블루	사블
怒槌	이카즈치	노퇴
My First Phone	마퍼폰
ENJOY POLIS	엔조이 폴리스
SHINY DAYS
ネ！コ！	네코
only my railgun	온리 마이 레일건	초전자포
ロールプレイングゲーム	알피지	롤플레잉게임
ヒバナ	히바나
ロキ	로키
Money Money	머니머니
極圏	극권
Scarlet Lance	스칼렛 랜스
セイクリッド　ルイン	세이크리드 루인
TiamaT:F minor	티아맷
EVERGREEN	에버그린
金の聖夜霜雪に朽ちて	금빛의 성야는 서리와 눈에 스러지고
不思議の国のクリスマス	이상한 나라의 크리스마스
Magical Sound Shower	매지컬 사운드 샤워
片想いサンバ	짝사랑 삼바
ナイトメア☆パーティーナイト	나이트메어 파티 나이트
フキゲンワルツ	저기압 왈츠
結ンデ開イテ羅刹ト骸	쥐었다가 펼쳐서 나찰과 송장	나찰과 송장	송장
サウンド	사운드
右肩の蝶	우견의 나비
カラフル×メロディ	칼라풀 멜로디	컬러풀 멜로디
L4TS:2018 (feat. あひる & KTA)
魔法少女になるしかねぇ	마법소녀
Kattobi KEIKYU Rider	카토비
B.M.S.	비엠에스
クレイジークレイジーダンサーズ	크레이지 크레이지 댄서즈
【東方ニコカラ】秘神マターラ feat.魂音泉【IOSYS】
隠然	은연
White Traveling Girl
-OutsideR:RequieM-	아웃사이더
イロトリドリのメロディ
奏者はただ背中と提琴で語るのみ	연주자는 그저 등과 바이올린으로 이야기할 뿐	연주자
ラブって♡ジュエリー♪えんじぇる☆ブレイク！！
ガチャガチャきゅ～と・ふぃぎゅ@メイト
true my heart -Lovable mix-
キミとボクのミライ	너와 나의 미래
Lost Princess
敗北の少年	패배의 소년
立ち入り禁止	출입금지
お気に召すまま	마음에 드시는 대로
命ばっかり	목숨뿐	생명뿐
Good Bye, Mr. Jack	미스터잭	굿바이 미스터잭
Altale	알테일
最終鬼畜妹フランドール・S	최종귀축	플랑드르 S	최종귀축 여동생 플랑드르 S
ネクロファンタジア～Arr.Demetori	데메토리
Imperishable Night 2006 (2016 Refine)
終点	종점
WORLD'S END UMBRELLA	월즈 엔드 엄브렐라
End Time	엔드타임	엔타
QZKago Requiem	쿠즈카고	큐지카고	큐지	쿠즈	쿠즈카고 레퀴엠	큐지카고 레퀴엠	쿠
Schwarzschild	슈바르츠	슈	슈바르츠실드
Alea jacta est!	주사위	아레아	알레아
FFT	프프티	에프에프티
雷切-RAIKIRI-	뇌절	라이키리
the EmpErroR	엠페러	엠
PANDORA PARADOXXX	판도라	판도라 파라독스	판파라	판파	판	판리마
Believe the Rainbow	빌리브 더 레인보우
BLACK ROSE	블랙로즈
Secret Sleuth
でらっくmaimai♪てんてこまい!
MAXRAGE	맥레	맥스레이지
バーチャルダム　ネーション	버츄얼담 네이션
P-qoq
超常マイマイン	초상 마이마인
Crazy Circle	크레이지 서클
STEREOSCAPE	스테레오스케이프
HOT LIMIT	핫 리밋
メルト	멜트
メルティランドナイトメア	멜티랜드 나이트메어
アディショナルメモリー	어디셔널 메모리	에디셔널 메모리
ナイト・オブ・ナイツ (Cranky Remix)	나오나 크랭키
Strobe♡Girl	스트로브 걸
イカサマライフゲイム	이카사마 라이프 게임	이카사마	사기 라이프 게임
STARTLINER	스타트라이너
アカリがやってきたぞっ	아카리	아카리가 찾아왔다구	아카리가 찾아왔다굿
Jump!! Jump!! Jump!!	점프 점프 점프
Scarlet Wings	스칼렛 윙즈
魔ジョ狩リ	마녀사냥
TwisteD! XD	트위스티드
Blows Up Everything	블로업
METEOR	메테오	미티어
グリーンライツ・セレナーデ	그린라이트 세레나데	그린라이츠 세레나데
だれかの心臓になれたなら	누군가의 심장이 될 수 있다면
39みゅーじっく！	39 뮤직
デビル☆アイドル	데빌 아이돌
デンパラダイム	덴파라다임
骸骨楽団とリリア	해골악단	해골악단과 리리아	해골악단과 릴리아
星屑ユートピア	별가루 유토피아
アマツキツネ	아마츠키츠네	천상의 여우
♡マイマイマイラブ♡	마이마이마이러브
徒花ネクロマンシー	수꽃 네크로맨시
目覚めRETURNER
一か罰
キリキリ舞Mine	키리키리 마이마인
福宿音屋魂音泉	복숙음옥혼음천	복숙음옥 타마온센	타마온센
Now or Never	나오네	나우 오어 네버
玩具狂奏曲 -終焉-	완구	완구광주곡	완구광주곡 종언
Titania	티타니아
Little "Sister" Bitch
Yakumo >>JOINT STRUGGLE (2019 Update)	야쿠모
げきオコスティックファイナリアリティぷんぷんマスタースパーク	격하게 화내며 마지막엔 뿜뿜 마스터 스파크
Agitation！
管弦楽組曲 第3番 ニ長調「第2曲（G線上のアリア）」BWV.1068-2	지선상	지선상의 아리아	G선상	G선상의 아리아
CocktaiL	칵테일
太陽系デスコ	태양계 디스코
だからパンを焼いたんだ
quiet room
TEmPTaTiON	템테	템테이션
アポカリプスに反逆の焔を焚べろ	아포칼립스
サヨナラチェーンソー	사요나라 체인소	사요나라 체인소우
幾望の月	기망의 달
BOKUTO	보구토
立川浄穢捕物帳	입천정예포물장	타치카와	타치카와 정예 포물장	삼도수군통제사
プナイプナイせんそう	프나이프나이 전쟁	프나이	프나이프나이
Bad Apple!! feat.nomico (REDALiCE Remix)	배드애플 레드앨리스
UniTas	유니타스
ここからはじまるプロローグ。	프롤로그
絡めトリック利己ライザー
モ°ルモ°ル	모루	몰루	모루모루	몰루몰루	모도루모도루
ヤミツキ	야미츠키	고질
ハム太郎とっとこうた	햄토리	함타로
青空のラプソディ	푸른 하늘의 랩소디	청공의 랩소디
だから僕は音楽を辞めた	그래서 나는 음악을 그만두었다
ラブ・ドラマティック feat. 伊原六花	러브 드라마틱	카구야
異世界かるてっと	이세계 콰르텟
ビターチョコデコレーション	비터 초코 데코레이션
アンドロイドガール	안드로이드 걸
スターリースカイ☆パレード	스타리 스카이 퍼레이드
スロウダウナー	슬로우 다우너
ソリッド	솔리드
Black Lair	블랙레어
馬と鹿	말과 사슴
energy trixxx	에너지 트릭스
NULCTRL	널컨	널컨트롤
アトロポスと最果の探究者	아트로포스	도서관	도서관누나	아트로포스와 진리의 탐구자
Valsqotch	발	발스코치	발스
最強 the サマータイム!!!!!
UTAKATA	우타카타
タテマエと本心の大乱闘	타테마에와 본심의 대난투	대난투
クレイジー・ビート	크레이지 비트
バイオレンストリガー	바이올런스 트리거	바이올렌스 트리거
グラーヴェ	그라베
KILLER B	킬러비
STEEL TRANSONIC	트랜소닉	스틸 트랜소닉
Flashkick	플래시킥
ブレインジャックシンドローム	브레인잭 신드롬
シエルブルーマルシェ	시엘블루 마르셰
Entrance	엔트런스
Lunar Mare	루나메어
Saika	사이카
CHAOS	카오스
Maboroshi	마보로시
六厘歌	육리가
ワードワードワード	워드워드워드
Catch the Wave
Stardust Memories
My My My	마이마이마이
共鳴	공명
Ututu
いつかいい感じにアレしよう
すーぱーぬこになれんかった	슈퍼 누코가 되지 못했어
アスヘノBRAVE
深海シティアンダーグラウンド	심해시티 언더그라운드
表裏一体	표리일체
I'm with you
オトモダチフィルム	오토모다치 필름
GRÄNDIR	그란디르
封焔の135秒	봉염	봉	봉염의 135초	135초
渦状銀河のシンフォニエッタ	나선은하	와상은하	신포니에타	심포니에타	나선은하의 신포니에타
全力ハッピーライフ	전력 해피 라이프
Oath Act	오스 액트
Witches night
Drive Your Fire
wheel	휠
CHOCOLATE BOMB!!!!	쵸밤	초밤	초콜릿밤
はちみつアドベンチャー	하치미츠 어드벤처
popcorn	팝콘
ウマイネームイズうまみちゃん
ぼくたちいつでも　しゅわっしゅわ！	슈와슈와
Boys O’Clock
居並ぶ穀物と溜息まじりの運送屋	늘어선 곡물과 한숨 섞인 운송업자
ARAIS	어라이즈
マイオドレ！舞舞タイム	마이오도레	마이마이 타임
宛城、炎上！！	엔죠	엔죠엔죠	엔조	엔조엔조
ノーポイッ!	노포이
町かどタンジェント	길모퉁이 마족	길모퉁이 탄젠트
紅蓮華	홍련화	귀칼	귀멸의 칼날
命に嫌われている	생명에게 미움받고 있어.
アンクローズ・ヒューマン	언클로즈 휴먼
乙女解剖	소녀해부
悪戯センセーション
Paranoia	파라노이아
BATTLE NO.1	배넘원	배틀넘버원
Jörqer	조커
Sqlupp (Camellia's "Sqleipd*Hiytex" Remix)	스클럽	스쿨럽
felys -final remix-	펠리스
Pretender	프리텐더
絶え間なく藍色	끊임없는 남색
ガランド	가란도	갈란드
とりあえずアナタがいなくなるまえに	아무튼 그대가 사라지기 전에	어쨌든 그대가 사라지기 전에
明星ギャラクティカ	명성 갤럭티카	샛별 갤럭티카
≠彡"/了→	키미츠아	키미투어
Aetheric Energy
Komplexe	컴플렉스
Beautiful Future	뷰티풀 퓨쳐	뷰티풀 퓨처
Mutation	뮤테	뮤테이션
MIRACLE RUSH	미라클 러시
お願いマッスル	오네가이 머슬	덤벨
絶対にチョコミントを食べるアオイチャン	민초	민트초코	초코민트	반드시 민트초코를 먹는 아오이짱	아오이
デリヘル呼んだら君が来た	데리헤루	데리헤루를 불렀더니 네가 왔어
シアトリカル・ケース	시어트리컬 케이스
c.s.q.n.
カラッポ・ノンフィクション	카라포 논픽션
emomomo	이모모모
レーイレーイ	레이레이
ベノム	베놈
マネマネサイコトロピック	마네마네	마네마네 사이코트로픽
オリフィス	오리피스
ユメヒバナ	유메히바나
REAL VOICE	리얼 보이스
パラボラ	파라볼라
YURUSHITE	유루시테
Climax	클막	클라이막스
Virtual to LIVE	버투라	버츄얼 투 라이브	니지산지
Arty Party	아티파티
Ether Strike	이더스트라이크	이더킥
Cyaegha	크아이가
Grievous Lady	그리버스	그리버스 레이디	그레
劣等上等	열등상등
アスノヨゾラ哨戒班	내일의 밤하늘 초계반
自傷無色	자상무색
絡繰りドール
物凄いヴァイブスで魔理沙が物凄いラップ
Sweet Requiem	스위트 레퀴엠
Dive into The Sky ～initialized～
Prismatic	프리스마틱
Regulus	레굴루스	레귤루스	레굴	레귤
ワンダーシャッフェンの法則	원더샤펜	원더샤펜의 법칙
BIRTH	버스
ポケットからぬりつぶせ！
トリドリ⇒モリモリ！Lovely fruits☆
Desperado Waltz	데스페라도	데스페라도 왈츠
BREaK! BREaK! BREaK!	브브브	브3
Heavenly Blast	헤븐리	헤블	헤븐리 블라스트
Paradisoda	파라디소다
VANTABLACK RAVER	반타블랙	반타블랙 레이버
時計の国のジェミニ	시계나라의 제미니
Xenovcipher	제노사이퍼	제노브사이퍼
インフェルノ	인페르노
冬のこもりうた	겨울 자장가	겨울의 자장가	자장가
God knows...	하루히
おジャ魔女カーニバル!!	도레미	오쟈마죠 카니발
秒針を噛む	초침을 깨물다
ネガティブ進化論	네거티브 진화론	네가티브 진화론
雨とペトラ	비와 페트라
永遠にゲームで対戦したいキリタン	키리탄	영원히 게임에서 대전하고 싶은 키리탄
KING	킹
ロストワードクロニカル	로스트 워드 크로니칼
今、誰が為のかがり火へ
Re：End of a Dream	리엔드
もぺもぺ	모페모페	모페
Sound Chimera	사운드키메라	키메라	사키
ハジマリノピアノ	하지마리노 피아노
タケモトピアノCMソング	타케모토	타케모토 피아노
オーケー？　オーライ！	오케 오라이	오케이 오라이	오케이 올라잇
サヨナラフリーウェイ	사요나라 프리웨이
単一指向性オーバーブルーム	단일지향성 오버블룸	오버블룸
みなえをチェック！	미나에	미나에 체크
CO5M1C R4ILR0AD	코스믹 레일로드	레일로드
MAKE IT FUNKY NOW	펑키	뻥키
Rush-More	러시모어
ステップアンドライム	스텝 앤드 라임
届かない花束
幽霊東京	유령도쿄	유령동경
Strange Bar	스트레인지 바	스바
Big Daddy	빅대디	대디
ベースラインやってる？笑	베이스라인	네네키미	베이스라인 하고 있어
ALiVE	얼라이브
ヒミツCULT	히미츠 컬트
MEGATON KICK	메가톤킥
LOSE CONTROL	루즈 컨트롤	루컨
星めぐり、果ての君へ。
スローアライズ	슬로 어라이즈
チエルカ／エソテリカ	치에르카	치에루카	치에르카 에소테리카	치에루카 에소테리카
生命不詳	생명부상	생명불상
Melody！	멜로디
下克上々	하극상	하극상상
ハウリング	하울링
トランスダンスアナーキー	트랜스 댄스 아나키
Last Samurai	라스트 사무라이
蒼穹舞楽	창공무악	창공
AMABIE	아마비에	아마비
乙女のルートはひとつじゃない！
ビックカメラのテーマソング	빅 카메라
電話革命ナイセン
Alice in 冷凍庫	앨리스 인 냉동고
キラメキ居残り大戦争	반짝이는 나머지 대전쟁	키라메키	키라메키 대전쟁
Never Give Up!	네버 기브 업
Starry Colors	스태리 컬러스	스타리 컬러스	스타리	스타리 컬러즈
ほしぞらスペクタクル	호시조라	호시조라 스펙타클	밤하늘	밤하늘 스펙타클	해파리냉채
VIIIbit Explorer	8비트	8비트 익스플로러	비비트
Shiny Smily Story	홀로라이브
ディカディズム	데카디즘
猫猫的宇宙論	냥냥적 우주론
ラットが死んだnew words	래트가 죽었다	래트가 죽었다 new words
阿吽のビーツ	아훔의 비트
再会	재회
約束	약속
トラフィック・ジャム	트래픽 잼
アルティメットセンパイ	얼티밋 선배	얼티메이트선배
BOUNCE & DANCE	바운스 앤 댄스
Kiss Me Kiss	키스 미 키스
MEGATON BLAST	메가톤 블라스트	메가톤 블래스트
Splash Dance!!	스플래시 댄스
宿星審判	수성심판	숙성심판
脳天直撃	뇌천	뇌천직격
とびだせ！TO THE COSMIC!!	토비다세	투더 코스믹
噛み係
トリアージ	트리아지
NAGAREBOSHI☆ROCKET	나가레보시	나가레보시 로켓	털로켓
夜に駆ける	밤을 달리다
うっせぇわ	우세와	웃세와	시끄러워
Shooting Stars
MOON NIGHTのせいにして
テレキャスタービーボーイ	텔레캐스터 비보이
僕は空気が嫁ない	나는 분위기를 읽지 못한다
デッドマンズバラッド	데드 맨즈 발라드
イヤホンロマンス	이어폰 로맨스
竹	타케	대나무
スーパーシンメトリー	슈퍼시메트리	수퍼시메트리
グッバイ宣言	굿바이 선언
Lia=Fail	리아페일
廻廻奇譚	회회기담
Southern Cross	썩던콩	사우던 크로스	남십자	남십자성
アンビバレンス	암비발렌스	앰비발렌스
さんさーら！	삼사라
Upshift	업시프트
MOBILYS	모빌리스
ドラゴンエネルギー	드래곤 에너지	드래곤 에네르기
セカイはまだ始まってすらいない	세상은 아직 시작조차 하지 않았어
アイドル新鋭隊	아이돌 신예대
needLe	니들
華の集落、秋のお届け	꽃의 마을	꽃의 집락	꽃의 마을 가을의 배달	꽃의 집락 가을의 배달
BLACK SWAN	블랙스완	블스
星詠みとデスペラード	호시요미	호시요미 데스페라도	별읽기	별읽기 데스페라도
Technicians High	테크니션	테크니션하이	테크니션즈 하이
Sweets Time	스윗스 타임
紅星ミゼラブル～廃憶編
幻想に咲いた花
マツヨイナイトバグ	마츠요이 나이트버그	마츠요이	나이트버그
ポッピンキャンディ☆フィーバー！	팝핑 캔디 피버	팝핀 캔디 피버
どぅーまいべすと！	두 마이 베스트
泥の分際で私だけの大切を奪おうだなんて	진흙	진흙탕	진흙탕 주제	진흙탕 주제에	진흙 주제	진흙 주제에	진흙탕 주제에 나만의 소중함을 빼앗으려 하다니
veil	베일
Round Round Spinning Around
Alcyone	알키오네	알시온	알사이온
Raven Emperor	레이븐	레이븐 엠페러
Yorugao	요루가오
U&iVERSE -銀河鸞翔-	은하난상	유니버스	황금밀크
VOLTAGE	볼티지
失敗作少女	실패작소녀
悪魔の踊り方	악마가 춤추는 법
ノイローゼ	노이로제
Seize The Day
響け！CHIREI MY WAY!
神々が恋した幻想郷
Destr0yer	디스트로이어
ぱくぱく☆がーる	파쿠파쿠 걸
No Limit RED Force	노리밋 레드포스
LiftOff	리프트오프
Falsum Atlantis.	팔섬
なだめスかし Negotiation（TVsize）
インドア系ならトラックメイカー	트랙메이커	인도어계라면 트랙메이커
ヒステリックナイトガール	히스테릭 나이트걸
ヨミビトシラズ	요미비토	요미비토시라즈
前衛的Landscape	전위적	전위적 랜드스케이프	전위적Landscape
Trick tear	트릭티어
躯樹の墓守	묘지기	죽은 나무의 묘지기
春嵐	춘람
ラグトレイン	라그트레인	래그트레인	렉트레인
アカツキアライヴァル	아카츠키 어라이벌
リモコン	리모컨	리모콘
on the rocks	온더락	온더락스
We Are Us
Limits	리밋스	리밋츠
スピカの天秤	스피카의 천칭
ハードコア・シンドローム	하드코어 신드롬
GIGANTØMAKHIA	기간토	기간토마키아
Halcyon	할시온
ミルキースター・シューティングスター	밀키스타 슈팅스타
ｉｓｏｐｈｏｔｅ
パラマウント☆ショータイム！！	파라마운트	파라마운트 쇼타임
Strive against fate	스트라이브
sølips	솔립스
テリトリーバトル	테리토리 배틀
Good bye, Merry-Go-Round.	굿바이 메리고라운드	메리고라운드
愛のシュプリーム！	사랑의 슈프림
くらべられっ子	비교 당하는 아이
あの世行きのバスに乗ってさらば。	저승으로 가는 버스를 타고 안녕  
うまぴょい伝説	우마뾰이	우마뾰이 전설	말딸	우마무스메
ヴァンパイア	뱀파이어
エンヴィーベイビー	엔비 베이비
初音天地開闢神話	천지개벽	하츠네 천지개벽 신화
Armageddon	아마게돈	아마겟돈
Dreadnought	드레드노트
8-EM
YONA YONA DANCE	요나요나댄스
若い力	와카이 치카라
遺伝子レベル∞スパイラル
otorii INNOVATED -[i]3-	오토리
enchanted love	인챈티드 러브
Caterpillar Song	캐터필러 송	캐터필러
Photon Melodies	포톤 멜로디스
吾輩よ猫であれ	이 몸이여 고양이가 되어라	우리들이여 고양이가 되기를	나는 고양이로소이다
　	공백	키사라기	키사라기역
BLUE ZONE	블루존
デーモンベット	데몬베드
パーフェクション	퍼펙션
サンバランド	삼바랜드
Love's Theme of BADASS ～バッド・アス 愛のテーマ～	배드애스	배드애스 러브
BANG!	뱅
Define	디파인
Mjölnir	묠니르
First Dance	퍼스트 댄스
Estahv	에스타브
HECATONCHEIR	헤카톤	헤카톤케어	헤카톤체어	헤카톤케일
Irresistible
HAGAKIRI	하가키리
N3V3R G3T OV3R	네버겟오버
春を告げる	봄을 고하다
オントロジー	온톨로지
剣を抜け！GCCX MAX
Princess♂
ヒトガタ	히토가타	인간형상
星空パーティーチューン	별하늘 파티튠	호시조라 파티튠	파티튠
チューリングの跡	튜링	튜링의 흔적
Swift Swing	스위프트 스윙
Sage	사게	세이지
全世界共通リズム感テスト	리듬감 테스트	전세계 리듬감 테스트
コスモポップファンクラブ	코스모팝 팬클럽
三妖精SAY YA!!!
紅に染まる恋の花
大輪の魂 (feat. AO, 司芭扶)	대륜의 혼
Spring of Dreams
OTOGEMA	오토게마
WiPE OUT MEMORIES	와이프아웃	와이프	와이프아웃 메모리즈
folern
ツクヨミステップ	츠쿠요미 스텝
白花の天使	백화의 천사
Jouez Avec Moi?
Metamorphosism	메타모포시즘
World's end loneliness	론리네스	론리니스	월즈엔드 론리네스	월즈엔드 론리니스	월엔	월엔론
エゴロック	에고 록
ジャンキーナイトタウンオーケストラ	정키 나이트 타운 오케스트라
パズルリボン	퍼즐리본
終焉逃避行	종언도피행
ただ選択があった	그저 선택이 있었어
Transcend Lights
撩乱乙女†無双劇
See The Light
エータ・ベータ・イータ	에타 베타 이타	에타 베타 에타
ホシシズク	호시시즈쿠
Rainbow Rush Story	레인보우 러시 스토리
Tricolor⁂circuS	트리컬러 서커스	트리컬러	트라이컬러
[X]	인피니티
分解収束テイル	분해수속 테일
蜘蛛の糸	거미줄
Don't Fight The Music	돈파뮤
アノーイング！さんさんウィーク！	어노잉 산산위크	어노잉 선선위크	선선위크
アニマル	애니멀
ジレンマ	딜레마
踊	오도
残響散歌	잔향산가
フォニイ	포니
ヴィラン	빌런
EYE
スカーレット警察のゲットーパトロール24時	스칼렛 경찰의 게토 패트롤 24시	스칼렛 경찰	게토 패트롤
田中	타나카
mystique as iris	미스티크	미스틱	이리스	아이리스
Random	랜덤
Luminaria	루미나리아
群青讃歌	군청찬가
セカイ	세카이
ワーワーワールド	와와월드
Catch Me If You Can
MAGNETAR GIRL
SUPER AMBULANCE	앰뷸런스	슈퍼앰뷸런스
銀のめぐり	은의 순환
Destiny Runner
アマカミサマ	아마카미사마
モンダイナイトリッパー！	몬다이나이 리퍼	
マーシャル・マキシマイザー	마셜 맥시마이저
秋の未確認生物	가을의 미확인생물
Rising on the horizon	호라이즌
You Mean the World to Me	you mean
Neon Kingdom
#狂った民族２ PRAVARGYAZOOQA	Crazy Nation 2
VSpook!
Dive into the ZONe
エナドリおいしいソング	enerdri oishii song	energy drink
RIFFRAIN
Falling
ピリオドサイン	피리오드 사인
群青シグナル	군청 시그널
Baddest
ばかみたい【Taxi Driver Edition】	바카미타이	바보같이	다메다메	다메다네
れっつ！みらくる☆はーどこあっ！
Blank Paper (Prod. TEMPLIME)
In my world (Prod. KOTONOHOUSE)
アイム・マイヒーロー
NightTheater
Ghost Dance
ピュグマリオンの咒文	피그말리온의 주문
電光石火	전광석화
Hainuwele
Beat Opera op.1
星見草	성견초
"411Ψ892"
康莊大道	강장대도
キュートなカノジョ	큐트한 그녀
へべれけジャンキー	고주망태 정키
きゅうくらりん	두근 어질
回る空うさぎ	회전하는 하늘 토끼
ボッカデラベリタ	보카 델라 베리타
『んっあっあっ。』	응아아
独りんぼエンヴィー	혼자 놀이 엔비
ロータスイーター	로터스 이터
トノサマビーム
enchanted wanderer
Comet Panto Men!
ツムギボシ	츠무기보시
FLUFFY FLASH
ヒバリ	히바리
Hello, Hologram
不機嫌なスリーカード
神っぽいな	신같아
魔法少女とチョコレゐト	마법소녀와 초콜렛
阿修羅ちゃん	아수라짱
おとせサンダー	오토세 선더
ロウワー	로워
キャットラビング	캣러빙
リスペク風神	리스펙풍신
Let you DIVE!
Knight Rider
INTERNET OVERDOSE
VeRForTe αRtE:VEiN
魂のルフラン
Shooting Shower～DANCE TIME(シンディ)～
Let you DIVE!
Knight Rider
INTERNET OVERDOSE
VeRForTe αRtE:VEiN
魂のルフラン
Shooting Shower～DANCE TIME(シンディ)～
Lights of Muse
tape/stop/night
Final Step! 
The 90's Decision 
僕の和風本当上手 
Cthugha 
ヱデン
にゃーにゃー冒険譚
BULK UP (GAME EXCLUSIVE EDIT) 
コンティニュー！ feat. 藍月なくる 
Sunday Night feat Kanata.N 
PERSONA feat. PANXI  
Halfway(>∀<)  
Complex Mind  
DROPS feat. Such  
花となれ
私のドッペルゲンガー
インターネットサバイバー
つるぺったん
『ウソテイ』 ～一回戦せりなvsしろなvsなずな～
Bad Apple!! feat.nomico ～五十嵐 撫子 Ver.～
Snow Colored Score
アンバークロニクル
リフヴェイン
宵の鳥
Kairos
